###############
#             #
# #W#W#W#W#W# #
#WWWWWWWWWWWWW#
#W#W#W#W#W#W#W#
#WWWWWWWWWWWWW#
#W#W#W#W#W#W#W#
#WWWWWWWWWWWWW#
#W#W#W#W#W#W#W#
#WWWWWWWWWWWWW#
#W#W#W#W#W#W#W#
#WWWWWWWWWWWWW#
# #W#W#W#W#W# #
#  WWWWWWWWW  #
###############