###############
#  WWWWWWWWW  #
# #W#W#W#W#W# #
#W#W#W#W#W#W#W#
#W#W#W#W#W#W#W#
#W#W#W#W#W#W#W#
#W#W#W#W#W#W#W#
#W#W#W#W#W#W#W#
#W#W#W#W#W#W#W#
#W#W#W#W#W#W#W#
#W#W#W#W#W#W#W#
#W#W#W#W#W#W#W#
# #W#W#W#W#W# #
#  WWWWWWWWW  #
###############